"filename", "language", "TypeScript", "Vue", "PostCSS", "XML", "comment", "blank", "total"
"e:\VUE_study\yournews\yournews\src\App.vue", "Vue", 0, 63, 0, 0, 4, 5, 72
"e:\VUE_study\yournews\yournews\src\api\admininfo.ts", "TypeScript", 4, 0, 0, 0, 2, 3, 9
"e:\VUE_study\yournews\yournews\src\api\apiverify.ts", "TypeScript", 7, 0, 0, 0, 2, 3, 12
"e:\VUE_study\yournews\yournews\src\api\ardata.ts", "TypeScript", 13, 0, 0, 0, 10, 2, 25
"e:\VUE_study\yournews\yournews\src\api\creator.ts", "TypeScript", 7, 0, 0, 0, 2, 3, 12
"e:\VUE_study\yournews\yournews\src\api\mainface.ts", "TypeScript", 10, 0, 0, 0, 7, 5, 22
"e:\VUE_study\yournews\yournews\src\api\readAr.ts", "TypeScript", 10, 0, 0, 0, 9, 4, 23
"e:\VUE_study\yournews\yournews\src\api\readeroptions.ts", "TypeScript", 7, 0, 0, 0, 2, 2, 11
"e:\VUE_study\yournews\yournews\src\api\tools.ts", "TypeScript", 4, 0, 0, 0, 1, 2, 7
"e:\VUE_study\yournews\yournews\src\api\user.ts", "TypeScript", 19, 0, 0, 0, 6, 7, 32
"e:\VUE_study\yournews\yournews\src\api\userinfo.ts", "TypeScript", 28, 0, 0, 0, 8, 9, 45
"e:\VUE_study\yournews\yournews\src\assets\404.svg", "XML", 0, 0, 0, 1, 0, 0, 1
"e:\VUE_study\yournews\yournews\src\assets\IP.svg", "XML", 0, 0, 0, 1, 0, 0, 1
"e:\VUE_study\yournews\yournews\src\assets\accountset.svg", "XML", 0, 0, 0, 1, 0, 0, 1
"e:\VUE_study\yournews\yournews\src\assets\avatar.svg", "XML", 0, 0, 0, 232, 0, 1, 233
"e:\VUE_study\yournews\yournews\src\assets\bock.svg", "XML", 0, 0, 0, 1, 0, 0, 1
"e:\VUE_study\yournews\yournews\src\assets\icon_cpq.svg", "XML", 0, 0, 0, 1, 0, 0, 1
"e:\VUE_study\yournews\yournews\src\assets\infoset.svg", "XML", 0, 0, 0, 1, 0, 0, 1
"e:\VUE_study\yournews\yournews\src\assets\qr.svg", "XML", 0, 0, 0, 1, 0, 0, 1
"e:\VUE_study\yournews\yournews\src\assets\straw.svg", "XML", 0, 0, 0, 1, 0, 0, 1
"e:\VUE_study\yournews\yournews\src\assets\time.svg", "XML", 0, 0, 0, 1, 0, 0, 1
"e:\VUE_study\yournews\yournews\src\assets\trans.svg", "XML", 0, 0, 0, 1, 0, 0, 1
"e:\VUE_study\yournews\yournews\src\assets\vue.svg", "XML", 0, 0, 0, 1, 0, 0, 1
"e:\VUE_study\yournews\yournews\src\components\accountSetting.vue", "Vue", 0, 229, 0, 0, 0, 5, 234
"e:\VUE_study\yournews\yournews\src\components\ardataChats.vue", "Vue", 0, 81, 0, 0, 0, 8, 89
"e:\VUE_study\yournews\yournews\src\components\basicInfo.vue", "Vue", 0, 119, 0, 0, 5, 3, 127
"e:\VUE_study\yournews\yournews\src\components\basicSetting.vue", "Vue", 0, 229, 0, 0, 0, 11, 240
"e:\VUE_study\yournews\yournews\src\components\mainView.vue", "Vue", 0, 63, 0, 0, 0, 3, 66
"e:\VUE_study\yournews\yournews\src\components\normalTools.vue", "Vue", 0, 153, 0, 0, 1, 4, 158
"e:\VUE_study\yournews\yournews\src\components\searchGithub.vue", "Vue", 0, 283, 0, 0, 6, 6, 295
"e:\VUE_study\yournews\yournews\src\components\searchLocal.vue", "Vue", 0, 120, 0, 0, 0, 4, 124
"e:\VUE_study\yournews\yournews\src\components\showsearchInput.vue", "Vue", 0, 265, 0, 0, 10, 11, 286
"e:\VUE_study\yournews\yournews\src\components\userLikesList.vue", "Vue", 0, 183, 0, 0, 3, 7, 193
"e:\VUE_study\yournews\yournews\src\components\writeArticle.vue", "Vue", 0, 96, 0, 0, 0, 5, 101
"e:\VUE_study\yournews\yournews\src\i18n\index.ts", "TypeScript", 57, 0, 0, 0, 1, 5, 63
"e:\VUE_study\yournews\yournews\src\main.ts", "TypeScript", 17, 0, 0, 0, 2, 3, 22
"e:\VUE_study\yournews\yournews\src\router\articleData.vue", "Vue", 0, 46, 0, 0, 0, 4, 50
"e:\VUE_study\yournews\yournews\src\router\createArticle.vue", "Vue", 0, 7, 0, 0, 0, 3, 10
"e:\VUE_study\yournews\yournews\src\router\error404.vue", "Vue", 0, 25, 0, 0, 1, 2, 28
"e:\VUE_study\yournews\yournews\src\router\index.ts", "TypeScript", 102, 0, 0, 0, 1, 4, 107
"e:\VUE_study\yournews\yournews\src\router\login.vue", "Vue", 0, 112, 0, 0, 0, 7, 119
"e:\VUE_study\yournews\yournews\src\router\myinfo.vue", "Vue", 0, 31, 0, 0, 0, 3, 34
"e:\VUE_study\yournews\yournews\src\router\readArticle.vue", "Vue", 0, 339, 0, 0, 1, 5, 345
"e:\VUE_study\yournews\yournews\src\router\reguser.vue", "Vue", 0, 163, 0, 0, 0, 5, 168
"e:\VUE_study\yournews\yournews\src\router\title.vue", "Vue", 0, 83, 0, 0, 1, 9, 93
"e:\VUE_study\yournews\yournews\src\router\userInfoSetting.vue", "Vue", 0, 151, 0, 0, 4, 10, 165
"e:\VUE_study\yournews\yournews\src\store\index.ts", "TypeScript", 7, 0, 0, 0, 0, 3, 10
"e:\VUE_study\yournews\yournews\src\store\modules\ardata.ts", "TypeScript", 48, 0, 0, 0, 1, 2, 51
"e:\VUE_study\yournews\yournews\src\store\modules\routerPinia.ts", "TypeScript", 15, 0, 0, 0, 1, 1, 17
"e:\VUE_study\yournews\yournews\src\store\modules\searchGithubPinia.ts", "TypeScript", 85, 0, 0, 0, 9, 2, 96
"e:\VUE_study\yournews\yournews\src\store\modules\searchInputPinia.ts", "TypeScript", 127, 0, 0, 0, 5, 2, 134
"e:\VUE_study\yournews\yournews\src\store\modules\types.ts", "TypeScript", 7, 0, 0, 0, 1, 1, 9
"e:\VUE_study\yournews\yournews\src\store\modules\user.ts", "TypeScript", 149, 0, 0, 0, 24, 3, 176
"e:\VUE_study\yournews\yournews\src\style.css", "PostCSS", 0, 0, 94, 0, 4, 11, 109
"e:\VUE_study\yournews\yournews\src\utils\http\index.ts", "TypeScript", 83, 0, 0, 0, 86, 8, 177
"e:\VUE_study\yournews\yournews\src\utils\http\types.d.ts", "TypeScript", 34, 0, 0, 0, 3, 6, 43
"e:\VUE_study\yournews\yournews\src\utils\progress\index.ts", "TypeScript", 10, 0, 0, 0, 5, 3, 18
"e:\VUE_study\yournews\yournews\src\utils\user.ts", "TypeScript", 37, 0, 0, 0, 5, 6, 48
"e:\VUE_study\yournews\yournews\src\vite-env.d.ts", "TypeScript", 5, 0, 0, 0, 1, 2, 8
"Total", "-", 892, 2841, 94, 243, 234, 223, 4527